######## #####
#H.....###...#
#............#
#......###...#
#......# #####
########